11111111
1P001111
10001C11
11111E11
11111111
