1111111111111111111111
1P001000C00000000000C1
1010101111010111111111
10101000C0010000000C01
1010101111010111101111
1000C000000100000000E1
1111111111111111111111
