1111111111111111111111
1P00000000000000000001
1000001111010111111111
1010000000010011100001
101000111101001E100001
1000000000010011100001
1111111111111111111111
