11111111
1P0X1C01
10000E01
11111111
