1111111111
1P001C0001
100010E000
1111111111
