11111111
1P001C01
1P001E01
11111111
