11111111
1P001C1
100E101
11111111
