11111111
1P000001
10000E01
11111111
