111111111
1P00100C1
111010101
100000101
101111101
1000C0001
111110111
10C0000E1
111111111
